
T3        ./assets/textures/wood.png
T r ./assets/textures/bluestone.png


T m ./assets/textures/eagle.png

T9 ./assets/textures/wood.png
T                     T                                ./assets/textures/colorstone.png

T D ./assets/textures/door.png
Te./assets/textures/mossy.png

Ty./assets/textures/purplestone.png

TQ./assets/textures/redbrick.png
T1./assets/textures/Asset_1.png

C 234,14,49
F     100,     200,     245

           11111111111111111111111111111111111111111111111111111111111
1111111111110000000000000m00000000000000000000000000000000000000000001
100000000000000000000000T 30000000000000000000000000000000000000000001
100000000000000000000S000100000000000000000000000000000000000000000001
1000000000000000000000000000000000000000000000000000000000111111111111
100000000000000011111D1111111111111111110000000000000000001
10000000000000001000000000000000000000000000000000000000001
1000000e0000000010101111D1111011111111110000000000000000001
1000000000000000100000000000101000000000000000000000000000m
10000000000000001110100000001010000001000000000000000000001
10000000000000000010100111111D11111101000000000099999990001
10000000000000000010100100000000000101000000000000000000001
10000000000000000010100D00000000000D01000000000000000000001
10000000000000000010100100000000000101000000000000000000001
10000000000000000010100111111D11111101000000000000000000001
100000000r0000000010000000000000000000000000000000000000001
10000000000000000010111111111111111111000000000000000000001
1000000000000000000000000000000000000000000000000000000000m
10000000000000000000000000000000000000000000000000000000001
10000000000000000000000000000000000000000000000000000000001
1000000000000y00000000000000000000000000000000000000000000T
10000000000000000000000000000000000000000000000000000000001
10000000000000000000000000000000000000000000000000000000001
1000000000000000000000000000000000000000000000000mQm0000001
11111111111111111111111111111111111111111111111111 11111111