
T3        ./assets/textures/wood.png
T r ./assets/textures/bluestone.png


T m ./assets/textures/eagle.png

T9 ./assets/textures/wood.png
T                     T                                ./assets/textures/colorstone.png


Te./assets/textures/mossy.png

Ty./assets/textures/purplestone.png

TQ./assets/textures/redbrick.png
T1./assets/textures/greystone.png

C 234,14,49
F     100,     200,     245

1111111111
1000000001
1000000001111111111111111111111111111111111
1000000000000000000000000000000000000000001
1011111111111111111111111111111111111111101
101                                     101
101   11111111111111111111111111111     101
101   10000000000000000000000000001     101111
101   10010010010001001000010000001     100001
101   1000000000000000000000000000111111101101
101   1001010110111011110000000000000000001101
1011111000000000000000000000000000111111101101
10000000000000000000100000000000001     101101
10111111111111111111111111111111111     101101
101                                     101101
101111111111111111111111111111111111111110110111
100000000000000000000000000000000000000000000001
111000111111111111111111111111111111111111111111
10000001
10000001
10000001
1000100111111111111111111111111111111111111111111111111111111111111111111111
1001010000000000000000000000000000000000000000000000000000000000000000000001
10001001111111111111111111111111111111111111111111111111111111111111111111011111
10001001                                                                10000001
10000001                                                                11110111
10000001                                                                11100011111111111111111111
10000001                                                                10000000000000000000000001
10000001                                                                10000000000000010000000001
10000001                                                                10000000000000000000000001
10000001                                                                10000000000111111100000001
10000001                                                                10000000000000000000000001
10000001                                                                10000000000000000000000001
10000001                                                                100011100000S0001111000001
10000001                                                                10000000000000000000000001
10000001                                                                10000000000000000000000001
10000001                                                                10000000000000000000000001
10000001                                                                10000000000001000010000001
10000001                                                                10000000000010000000110001
10000001                                                                10000011000001000010100001
10000001                                                                11111100000110000000000001
10000001                                                                10000000000000000010000001     
10000001                                                                11111111100000000000010001     
10000001                                                                1000100010000000000000000111111
10000001                                                                1010001001000001110000000000001
10000001                                                                1011111101000001 10000000000001
10000001                                                                1000000000000001 10000000000001
10000001                                                                1010111111111111 11111111111111
11000011111111111111111111111111111111111111111111111111111111111111111110101
10000000000000000000000000000000000000000000000000000000000000000000000000001
10111111111111111111111111111111111111111111111001111111111111111111111111111
10100000000000000000000000000000000000000000001001
10101111111111111111111111111111111111111111001001
10101000000000000000000000000000000000000001001001
10101011111111111111111111111111111111111001001001
10101010000000000000000000000000000000001001001001
10101010111111111111111111111111111111001001001001
10101010100000000000000000000000000001001001001001
10101010101111111111111111111111111001001001001001
10101010101000000000000000000000001001001001001001
10101010101011111111111111111111001001001001001001
10101010101010000000000000000001001001001001001001
10101010101010111111111111111001001001001001001001
10101010101010100000000000001001001001001001001001
10101010101010101111111111001001001001001001001001
10100000101010100000000001001001001001001001000001
10111111101010111111111001001001001001001001111101111111
10000000000000000000000000000000000000000000000000000001
11111111111111111111111111111111111111111111111111111111