
SO        ./assets/textures/se.png
NO         ./assets/textures/no.png
WE ./assets/textures/we.png
EA ./assets/textures/ea.png

F     255,242,234
C     14,14,49

1111111111
1000000001
1000000001111111111111111111111111111111111
1000000000000000000000000000000000000000001
1011111111111111111111111111111111111111101
101                                     101
101   11111111111111111111111111111     101
101   10000000000000000000000000001     101111
101   10010010010001001000010000001     100001
101   1000000000000000000000000000111111101101
101   1001010110111N11110000000000000000001101
1011111000000000000000000000000000111111101101
10000000000000000000100000000000001     101101
10111111111111111111111111111111111     101101
101                                     101101
101111111111111111111111111111111111111110110111
100000000000000000000000000000000000000000000001
111000111111111111111111111111111111111111111111
1111111
