1111111111
1000000001
100000N001
1000000001
1011111111
111