1111111111
1000000001
1000000001111111111111111111111111111111111
1000000000000000000000000000000000000000001
1011111111111111111111111111111111111111101
101                                     101
101   11111111111111111111111111111     102
101   10000000000000000000000000001     101111
101   10020020020002002000020000001     000001
101   1000000000000000000000000000111111101303
101   10030303303333333300000000000000000023NE
101   100000000000000000000000000011111110130F
101   10000000000000000000000000001     101301
101   11111111111111111111111111111     101302
101                                     101302
101539213131231111111111111111111111111110110244
100000000000000000000000000000000000000000000004
111000111111111111111111111111111111111111111444
1111111