
SO        ./bonus/assets/textures/mossy.png



NO ./bonus/assets/textures/greystone.png


WE ./bonus/assets/textures/mossy.png


EA ./bonus/assets/textures/greystone.png

F     90,     20,     245


C     16    ,   14     ,49

11111111
10000001
10S0100111111111111111111111111111111111111111111111111111111111111111111111
1001 10000000000000000000000000000000000000000000000000000000000000000000001
10001001111111111111111111111111111111111111111111111111111111111111111111011111
10001001                                                                10000001
10000001                                                                11110111
10000001                                                                11100011111111111111111111
10000001                                                                10000000000000000000000001
10000001                                                                10000000000000010000000001
10000001                                                                10000000000000000000000001
10000001                                                                10000000000111111100000001
10000001                                                                10000000000000000000000001
10000001                                                                10000000000000000000000001
10000001                                                                10001110000000001111000001
10000001                                                                10000000000000000000000001
10000001                                                                10000000000000000000000001
10000001                                                                10000000000000000000000001
10000001                                                                10000000000001000010000001
10000001                                                                10000000000010000000110001
10000001                                                                10000011000001000010100001
10000001                                                                11111100000110000000000001
10000001                                                                10000000000000000010000001     
10000001                                                                11111111100000000000010001     
10000001                                                                1000100010000000000000000111111
10000001                                                                1010001001000001110000000000001
10000001                                                                1011111101000001 10000000000001
10000001                                                                1000000000000001 10000000000001
10000001                                                                1111111111111111 11111111111111
11000011111111111111111111111111111111111111111111
10000000000000000000000000000000000000000000000001
10111111111111111111111111111111111111111111111001
10100000000000000000000000000000000000000000001001
10101111111111111111111111111111111111111111001001
10101000000000000000000000000000000000000001001001
10101011111111111111111111111111111111111001001001
10101010000000000000000000000000000000001001001001
10101010111111111111111111111111111111001001001001
10101010100000000000000000000000000001001001001001
10101010101111111111111111111111111001001001001001
10101010101000000000000000000000001001001001001001
10101010101011111111111111111111001001001001001001
10101010101010000000000000000001001001001001001001
10101010101010111111111111111001001001001001001001
10101010101010100000000000001001001001001001001001
10101010101010101111111111001001001001001001001001
10100000101010100000000001001001001001001001000001
10111111101010111111111001001001001001001001111101111111
10000000000000000000000000000000000000000000000000000001
11111111111111111111111111111111111111111111111111111111
