
T3        ./bonus/assets/textures/wood.png
T r ./bonus/assets/textures/colorstone.png


T m ./bonus/assets/textures/eagle.png
T D ./bonus/assets/textures/door.png

T                     J                                ./bonus/assets/textures/colorstone.png

T1./bonus/assets/textures/Asset_2.png

Te./bonus/assets/textures/Asset_1.png

Ty./bonus/assets/textures/purplestone.png

TQ./bonus/assets/textures/Asset_3.png

C234,14,49
F     100,     200,     245
           11111111111111111111111111111111111111111111111111111111111
1111111111110000000000000m00000000000000000000000000000000000000000001
100000000000000000000000J m0000000000000000033000000000000000000000001
1000000000000000000000000100000000000000000033000000000000000000000001
1000000000000000000000000000000000000000000000000000000000111111111111
10000000000000001111111111111111111111111111000000000000001
1000000000000E00D00000000000000000000000000D000000000000001
1000000e000000001010111111111011111111111111000000000000001
1000000000000000100000000000101000000000000100000000000000m
10000000000000001110100000001010000000000001000000000000001
10000000000000000010100111111D111111D111D111mmmmmmmDmmmmmm1
10000000000000000010100100000000000101000001000000000000001
10000000000000000010100D00000000000D0100000D0m0m0m0000m0m01
10000000000000000010100100000000000101000001000000000000001
1000000000000000001D100111111D111111D1011111111111D11111D11
100000000r0000000010000000000000000000000000000000000010001
100000000000000000101111111111111D1111111111110000000010001
100000000000000000000000000000000000000000000100000000D000m
10000000000000000000000000000000000000000000010000000010001
10000000000000000000000000000000000000000000010000000010001
1000000000000y0000000000000000000000000000000111111D1111D1J
10000000000000000000000000000000000000000000000000000000001
10000000000000000000000000000000000000000000000000000000001
1000000000000000000000000000000000000000000000000mQm0000001
11111111111111111111111111111111111111111111111111 11111111