


SO        ./assets/textures/wood.png



NO ./assets/textures/pillar.png


WE ./assets/textures/mossy.png


EA ./assets/textures/pillar.png

F     90,     20,     245


C     16    ,   14     ,49

11111111111111111111111111111111111111111111111111
1S000000000111111111111111111111111100000000000001
11111111000100000000000000000000000101111111111001
10000001000101111111111111111111000100000000001001
10111101000101000000000000100001000101111111101001
10100101000101011111111110101001000101000000101001
10100101110101010000000110101001000101011110101001
10100100010101010111110110101001000101010000101001
10100111010101010010010110101001000101010111101001
10100000010101010010010110000001000101010000101001
10111111110101011110010111111111000101011110101101
10000000000101000010000000000000000101000000100001
11111111110101111110111111111111110101111111101111
10000000000100000000100000000000000100000000000001
10111111111111111110101111111111111111111111111001
10000000000000000100100000000000000000000000001001
10111111111111010111111111111111111111111111101001
10000000000001010000000000000000000000000000101001
10111111111001011111111111111111111111111110101001
10100000001000000000000000000000000000000000101001
10101111111111111111111111111111111111111111101001
10001000000000000000000000000000000000000000001001
10111011111111111111111111111111111111111111111001
10100000000000000000000000000000000000000000000001
11111111111111111111111111111111111111111111111111