SO        ./default/assets/textures/bluestone.png



NO ./default/assets/textures/eagle.png


WE ./default/assets/textures/redbrick.png


EA ./default/assets/textures/mossy.png

F     1,     200,     245
C     90    ,   14     ,49

     11111111111111111111111111
     10000000000000000010000001
     10000000000010000000110001
     10000011000001000010100001
1111110000011000000000000111111
10000000000000000010000001     
11111111100000000000010001     
1000100010000000000000000111111
1010001001000001110000000000001
1011111101000001 10N00000000001
1000000000000001 10000000000001
1111111111111111 11111111111111